▓▓▓▓▓▓▓▓▓▓▓▓▓▓▓▓▓▓▓▓▓▓▓▓▓▓▓                                 
▓                         ▓                                 
▓                         ▓                                 
▓                         ▓▓▓▓▓▓▓▓▓▓▓▓▓▓▓▓▓▓▓▓▓▓▓▓▓▓▓▓▓▓▓▓▓▓
▓                                                          ▓
▓▓▓▓▓▓▓▓▓▓▓▓▓▓                                             ▓
             ▓                                             ▓
             ▓            ▓▓▓▓▓▓▓▓▓▓                       ▓
             ▓            ▓        ▓                       ▓
             ▓            ▓        ▓                       ▓
             ▓            ▓        ▓                       ▓
             ▓            ▓        ▓                       ▓
             ▓            ▓        ▓                       ▓
             ▓            ▓        ▓                       ▓
             ▓            ▓        ▓                       ▓
             ▓            ▓        ▓▓▓▓▓▓▓▓▓   ▓▓▓▓▓▓▓▓▓▓▓▓▓
             ▓            ▓                ▓   ▓            
             ▓            ▓                ▓   ▓            
             ▓            ▓                ▓   ▓            
             ▓▓▓▓▓   ▓▓▓▓▓▓                ▓   ▓            
                 ▓   ▓                     ▓   ▓            
                 ▓   ▓ ▓▓▓▓▓▓▓▓▓▓▓▓▓▓▓▓▓▓▓▓▓   ▓            
                 ▓   ▓ ▓                       ▓            
                 ▓   ▓ ▓                       ▓            
                 ▓   ▓ ▓                       ▓            
                 ▓   ▓ ▓                       ▓            
                 ▓   ▓ ▓                       ▓            
                 ▓   ▓ ▓                       ▓            
                 ▓   ▓▓▓                       ▓            
                 ▓                             ▓            
                 ▓                             ▓            
                 ▓                             ▓            
                 ▓▓▓▓▓▓▓                       ▓            
                       ▓                       ▓            
                       ▓                       ▓            
                       ▓                       ▓            
                       ▓                       ▓            
                       ▓                       ▓            
                       ▓                       ▓            
                       ▓                       ▓            
 ▓▓▓▓▓▓▓▓▓▓▓▓▓▓▓▓▓▓▓▓▓ ▓                       ▓            
 ▓                   ▓ ▓▓▓  ▓▓▓▓▓▓▓▓▓▓▓▓▓▓▓  ▓▓▓            
 ▓                   ▓   ▓  ▓             ▓  ▓              
 ▓                   ▓   ▓  ▓             ▓  ▓              
 ▓                   ▓   ▓  ▓        ▓▓▓▓▓▓  ▓▓▓▓▓▓▓▓▓▓▓▓▓  
 ▓                   ▓   ▓  ▓        ▓                   ▓  
 ▓                   ▓   ▓  ▓        ▓                   ▓  
 ▓                   ▓   ▓  ▓        ▓                   ▓  
 ▓                   ▓   ▓  ▓        ▓                   ▓  
 ▓                   ▓▓▓▓▓  ▓        ▓                   ▓  
 ▓                          ▓        ▓                   ▓  
 ▓                          ▓        ▓                   ▓  
 ▓                   ▓▓▓▓▓▓▓▓        ▓                   ▓  
 ▓                   ▓               ▓                   ▓  
 ▓                   ▓               ▓                   ▓  
 ▓                   ▓               ▓                   ▓  
 ▓                   ▓               ▓                   ▓  
 ▓                   ▓               ▓                   ▓  
 ▓▓▓▓▓▓▓▓▓▓▓▓▓▓▓▓▓▓▓▓▓               ▓                   ▓  
                                     ▓▓▓▓▓▓▓▓▓▓▓▓▓▓▓▓▓▓▓▓▓  